#########################################################################################################################
#                                     #                                         #                                       #
#                                     #                                         #                                       #
#                                     #                                         #                                       #
#                                     #                                         #                                       #
#                                     #                                         #                                       #
#                                     #                                         #                                       #
#                                     #                                         #                                       #
#                                     #                                         #                                       #
#                                     #                                         #                                       #
#                                     #                                         #                                       #
#                                     #                                         #                                       #
#                                                                                                                       #
#                                                                                                                       #
#                                                                                                                       #
#                                                                                                                       #
#                                                                                                                       #
#                                                                                                                       #
#                                                                                                                       #
#                                                                                                                       #
#                                                                                                                       #
#                                                                                                                       #
#                                                                                                                       #
#                                                                                                                       #
#                                                                                                                       #
#########################################################################################################################

