##############################################################
||................................................  ......  ||
||..%%%%%%%%%                %%%%%%%%%%%%%%  |%|..   %%%%%  ||
||..|%| ..|%|     |%|        |%         |%|  |%|..    |%|   ||
||..|%| ..|%|     |%|        |%|        |%|  |%|..    |%|   ||
||..%%%   %%  . . |%|                           ..   %%%%%  ||
||..|%|       . . |%|       ...............  ..             ||
||..%%%%%%%%%%. .   G     %%%%%%%%%%%%%%%%    %%%%%%%%%%%   ||
||..                      |%|    ......|%|    |%|........   ||
||..   |%|..      |%|..   |%|    .%%%%%|%|    |%|........   ||
||..   |%|..      |%|..   |%|    ......|%|    |%||%||%||%|  ||
||..   |%|..      |%|..   %%%    ......|%|          ...|%|. ||
||..   |%|..      |%|..   |%|     %%%%%%            ...|%|. ||
||..                      |%|                       ...|%|. ||
||..%%%%%%%%%%%           |%|%%%%%%%%%%%%     %%%%%%%%%%%   ||
||..                                                        ||
||............................   .........................  ||
||..|%|  |%|   |%|   %%%%%%%%%   |%||%||%||%|%|    %%%%%    ||
||..|%|  |%|   |%|        |%|      .........|%|       |%|   ||
||..|%|  |%|   |%|        |%|               |%|       |%|   ||
||..|%|  |%|   |%|                |%||%||%|%|%|    %%%%%    ||
||..                              |%|                       ||
||..........      .............................    .......  ||
||..   |%|..      %%%%%%%%%%%%   |%||%||%||%|%|    %%%%%%   ||
||..   |%|..              |%|      .........|%|    |%|..    ||
||..                      |%|      .........|%|    |%|..    ||
||..%%%%%%%%%%%           |%|%%%%%%%%%%     |%|    %%%%%%   ||
||..........................................................||
##############################################################